NO ./textures/north.png
SO ./textures/south.png
WE ./textures/west.png
EA ./textures/east.png

F 0,50,0
C 0,0,50

        11111
        10001     
        10001
        11011
1111111111011111111011110
1000000000000000000100001
1000000000000000000000001
10001000000000E0000000001
1000010000000000000000001
1000000000000000000000001
1000000000000000000000001
1111111111111111111111111
