NO ./textures/north.png
SO ./textures/south.png
WE ./textures/west.png
EA ./textures/east.png


F 0,0  ,  50
C 0,50,0

111111111111
100000000001
100000000001
1000000N0001
100000000001
100000000001
111111111111
       1
      101
     10001
    1000001
   100000001
  10001000001
 1001000000001
100000000000001
111111111111111
