NO ./textures/north.png
SO ./textures/south.png
WE ./textures/west.png
EA ./textures/east.png

F 220,100,99
C 225,30,0

1111111111111111111111111
1000000000000000000000001
1000000S00000000000000001
1000000000NE0000000000000
100000000000000000W000001
1111111111111111111111111
