NO ./textures/north.png
SO ./textures/south.png
WE ./textures/west.png
EA ./textures/east.png

F 220,100,99
C 225,30,0

11111
100N0000
11111
